{
    "home": {
        "width": 16,
        "height": 16,
        "tilesize": 16,
        "collisions": [125],
        "data": [
            [160, 161, 160, 161, 160, 161, 160, 161, 160, 161, 160, 161, 160, 161, 161, 161],
            [160, 161, 162, 161, 160, 161, 160, 161, 160, 161, 160, 161, 160, 161, 160, 161],
            [176, 177, 176, 177, 176, 177, 176, 177, 176, 177, 176, 177, 176, 177, 160, 177],
            [176, 177, 176, 177, 176, 177, 176, 177, 176, 177, 176, 177, 176, 177, 176, 177],
            [160, 161, 160, 161, 160, 161, 160, 161, 160, 161, 160, 163, 160, 161, 160, 161],
            [176, 177, 176, 177, 163, 177, 176, 177, 176, 177, 176, 177, 176, 177, 176, 177],
            [160, 161, 179, 161, 160, 161, 179, 161, 177, 161, 160, 161, 160, 163, 160, 161],
            [176, 177, 176, 177, 176, 177, 176, 177, 176, 177, 176, 177, 176, 177, 176, 177],
            [160, 161, 160, 161, 160, 161, 160, 161, 160, 162, 179, 161, 160, 161, 160, 161],
            [176, 177, 176, 177, 162, 177, 176, 177, 176, 177, 176, 177, 176, 177, 176, 177],
            [160, 161, 160, 161, 160, 161, 160, 161, 160, 161, 160, 161, 160, 161, 160, 161],            
            [176, 160, 176, 177, 176, 177, 176, 177, 176, 177, 176, 177, 176, 177, 176, 177],
            [176, 177, 178, 177, 176, 177, 176, 177, 176, 177, 176, 177, 176, 177, 176, 177],
            [160, 161, 160, 161, 161, 161, 179, 161, 160, 161, 160, 161, 160, 161, 160, 161],
            [160, 161, 179, 179, 160, 161, 178, 161, 160, 161, 179, 161, 160, 161, 179, 161],
            [160, 161, 162, 161, 160, 177, 160, 161, 160, 161, 179, 178, 160, 161, 160, 161]
        ],
        "props": [
            { "kind":2, "x":5, "y":8 },
            { "kind":3, "x":1, "y":1 },
            { "kind":3, "x":1, "y":9 }
        ],
        "portals": [
            { "x":13, "y":7, "target": "dungeon" }
        ]
    }, 
    "dungeon": {
        "width": 15,
        "height": 15,
        "tilesize": 16,
        "collisions":[],
        "data": [
            [6, 7, 8, 9, 10, 7, 8, 9, 10, 7, 8, 9, 10, 7, 11],
            [70, 71, 72, 73, 74, 71, 72, 73, 74, 71, 72, 73, 74, 71, 75],
            [22, 23, 24, 25, 26, 23, 24, 25, 26, 23, 24, 25, 26, 23, 27],
            [38, 39, 40, 41, 42, 39, 40, 41, 42, 39, 40, 41, 42, 39, 43],
            [54, 55, 56, 57, 58, 55, 56, 57, 58, 55, 56, 57, 58, 55, 59],
            [70, 71, 72, 73, 74, 71, 72, 73, 74, 71, 72, 73, 74, 71, 75],
            [22, 23, 24, 25, 26, 23, 24, 25, 26, 23, 24, 25, 26, 23, 27],
            [38, 39, 40, 41, 42, 39, 40, 41, 42, 39, 40, 41, 42, 39, 43],
            [54, 55, 56, 57, 58, 55, 56, 57, 58, 55, 56, 57, 58, 55, 59],
            [70, 71, 72, 73, 74, 71, 72, 73, 74, 71, 72, 73, 74, 71, 75],
            [22, 23, 24, 25, 26, 23, 24, 25, 26, 23, 24, 25, 26, 23, 27],
            [38, 39, 40, 41, 42, 39, 40, 41, 42, 39, 40, 41, 42, 39, 43],
            [54, 55, 56, 57, 58, 55, 56, 57, 58, 55, 56, 57, 58, 55, 59],
            [70, 71, 72, 73, 74, 71, 72, 73, 74, 71, 72, 73, 74, 96, 75],
            [86, 87, 88, 89, 90, 87, 88, 89, 90, 87, 88, 89, 90, 87, 91]
        ],
        "props": [],
        "portals": [
            { "x":13, "y":13, "target": "home" }
        ]
    }
}